[
    {
        "level": 1,
        "data": [
            [   0,   0,   0, 100, 100, 100,   0,   0,   0,   0],
            [   0,   0,   0, 100,  51, 100,   0,   0,   0,   0],
            [   0,   0,   0, 100,   0, 100, 100, 100, 100,   0],
            [   0, 100, 100, 100,   8,   0,   8,  51, 100,   0],
            [   0, 100,  51,   0,   8,  52, 100, 100, 100,   0],
            [   0, 100, 100, 100, 100,   8, 100,   0,   0,   0],
            [   0,   0,   0,   0, 100,  51, 100,   0,   0,   0],
            [   0,   0,   0,   0, 100, 100, 100,   0,   0,   0]
        ],
        "mixin": false,
        "title": "1-1"
    },
    {
        "level": 2,
        "data": [
            [   0,   0,   0, 100, 100, 100,   0,   0,   0,   0],
            [   0,   0, 100, 100,  51, 100,   0,   0,   0,   0],
            [   0,   0, 100,   0,   8, 100, 100, 100, 100,   0],
            [   0, 100, 100,   0,   0,   0,   8,  52, 100,   0],
            [   0, 100,  51,   0,   8,   8,  51, 100, 100,   0],
            [   0, 100, 100, 100, 100,   0, 100,   0,   0,   0],
            [   0,   0,   0,   0, 100,  51, 100,   0,   0,   0],
            [   0,   0,   0,   0, 100, 100, 100,   0,   0,   0]
        ],
        "mixin": false,
        "title": "1-2"
    },
    {
        "level": 3,
        "data": [
            [   0,   0,   0,   0,   0,   0,   0,   0,   0,   0],
            [   0,   0, 100, 100, 100,   0,   0,   0,   0,   0],
            [   0,   0, 100,  51, 100, 100, 100, 100, 100,   0],
            [   0,   0, 100,  51,  51,   0,   0,   0, 100,   0],
            [   0,   0, 100,   0,   8,   8,   8,  52, 100,   0],
            [   0,   0, 100,   0,   0,   0,   0, 100,   0,   0],
            [   0,   0, 100, 100, 100, 100, 100, 100,   0,   0],
            [   0,   0,   0,   0,   0,   0,   0,   0,   0,   0]
        ],
        "mixin": false,
        "title": "1-3"
    },
    {
        "level": 4,
        "data": [
            [ 100, 100, 100, 100, 100, 100,   0,   0,   0,   0],
            [ 100,  51,  51,  51,  51, 100, 100, 100, 100,   0],
            [ 100,   0,   0,   8, 100, 100,   0,   0, 100,   0],
            [ 100,   0,   8,   8,   0,   0,   0,   0, 100,   0],
            [ 100,  52,   8,   0,   0,   0,   0,   0, 100,   0],
            [ 100, 100,   0,   0, 100, 100, 100, 100, 100,   0],
            [   0, 100, 100, 100, 100,   0,   0,   0,   0,   0],
            [   0,   0,   0,   0,   0,   0,   0,   0,   0,   0]
        ],
        "mixin": false,
        "title": "1-4"
    },
    {
        "level": 5,
        "data": [
            [   0,   0,   0, 100, 100, 100, 100,   0,   0,   0],
            [   0,   0,   0, 100,   0,  52, 100, 100, 100,   0],
            [   0,   0,   0, 100,   8,   8,   0,   0, 100,   0],
            [   0, 100, 100, 100,   0,   8,  51,   0, 100,   0],
            [   0, 100,  51,  51,  51,   0, 100, 100, 100,   0],
            [   0, 100, 100, 100,   8,   0, 100,   0,   0,   0],
            [   0,   0,   0, 100,   0,   0, 100,   0,   0,   0],
            [   0,   0,   0, 100, 100, 100, 100,   0,   0,   0]
        ],
        "mixin": false,
        "title": "1-5"
    },
    {
        "level": 6,
        "data": [
            [   0,   0,   0,   0,   0,   0,   0,   0,   0,   0],
            [   0,   0,   0,   0, 100, 100, 100, 100,   0,   0],
            [   0,   0, 100, 100, 100,   0,   0, 100,   0,   0],
            [   0,   0, 100,   0,   9,  38,   0, 100,   0,   0],
            [   0,   0, 100,   0,   7,  64,   0, 100,   0,   0],
            [   0,   0, 100,  52,   0,   0, 100, 100,   0,   0],
            [   0,   0, 100, 100, 100, 100, 100,   0,   0,   0],
            [   0,   0,   0,   0,   0,   0,   0,   0,   0,   0]
        ],
        "mixin": false,
        "title": "2-1"
    },
    {
        "level": 7,
        "data": [
            [   0,   0,   0,   0,   0,   0,   0,   0,   0,   0],
            [   0,   0, 100, 100, 100, 100, 100, 100,   0,   0],
            [   0,   0, 100,   0,   0,   0,  52, 100,   0,   0],
            [   0,   0, 100,   0, 764,   0,   0, 100,   0,   0],
            [   0,   0, 100,   0, 938,   0, 100, 100,   0,   0],
            [   0,   0, 100, 100,   0,   0, 100,   0,   0,   0],
            [   0,   0,   0, 100, 100, 100, 100,   0,   0,   0],
            [   0,   0,   0,   0,   0,   0,   0,   0,   0,   0]
        ],
        "mixin": true,
        "title": "2-2"
    },
    {
        "level": 8,
        "data": [
            [0,  0,  0,  0,  0,  0,  0,  0,  0,  0],
            [0,  0,100,100,100,100,100,  0,  0,  0],
            [0,100,  0,  0,  0,  0,100,100,  0,  0],
            [0,100,  0,  0,764,938,  0,100,  0,  0],
            [0,100,  0,  0,  0,  0,  0,100,  0,  0],
            [0,100, 52,  0,100,100,100,100,  0,  0],
            [0,100,100,100,100,  0,  0,  0,  0,  0],
            [0,  0,  0,  0,  0,  0,  0,  0,  0,  0]
        ],
        "mixin": true,
        "title": "2-3"
    },
    {
        "level": 9,
        "data": [
            [0,  0,  0,  0,  0,  0,  0,  0,  0,  0],
            [0,  0,  0,100,100,100,100,100,  0,  0],
            [0,100,100,100,  0,  0,  0,100,  0,  0],
            [0,100, 64,  7,  0,  9, 38,100,  0,  0],
            [0,100,  0,  0,  0,  0,  0,100,  0,  0],
            [0,100,100,100,100,  0, 52,100,  0,  0],
            [0,  0,  0,  0,100,100,100,100,  0,  0],
            [0,  0,  0,  0,  0,  0,  0,  0,  0,  0]
        ],
        "mixin": false,
        "title": "2-4"
    },
    {
        "level": 10,
        "data": [
            [0,  0,  0,  0,  0,  0,  0,  0,  0,  0],
            [0,  0,100,100,100,100,100,100,  0,  0],
            [0,100,100,  0, 38,  0,  0,100,  0,  0],
            [0,100,  0,  7,100,  9,  0,100,  0,  0],
            [0,100,  0,  0, 64,  0,  0,100,  0,  0],
            [0,100,100,100,100,  0, 52,100,  0,  0],
            [0,  0,  0,  0,100,100,100,100,  0,  0],
            [0,  0,  0,  0,  0,  0,  0,  0,  0,  0]
        ],
        "mixin": true,
        "title": "2-5"
    },
    {
        "level": 11,
        "data": [
            [0,  0,100,100,100,100,  0,  0,  0,  0],
            [0,100,100,  0,  0,100,  0,  0,  0,  0],
            [0,100, 52,  0,  7,100,100,  0,  0,  0],
            [0,100,  0, 38, 64,  0,100,  0,  0,  0],
            [0,100,  0,  9,  0,  0,100,  0,  0,  0],
            [0,100,100,  0,  0,100,100,  0,  0,  0],
            [0,  0,100,100,100,100,  0,  0,  0,  0],
            [0,  0,  0,  0,  0,  0,  0,  0,  0,  0]
        ],
        "mixin": false,
        "title": "2-6"
    },
    {
        "level": 12,
        "data": [
            [0,  0,  0,  0,  0,  0,  0,  0,  0,  0],
            [0,100,100,100,100,100,100,  0,  0,  0],
            [0,100, 52,  0,  0,  0,100,100,  0,  0],
            [0,100,  0,  8,  9,  7,  0,100,  0,  0],
            [0,100,100, 38, 64, 51,  0,100,  0,  0],
            [0,  0,100,100,100,100,100,100,  0,  0],
            [0,  0,  0,  0,  0,  0,  0,  0,  0,  0],
            [0,  0,  0,  0,  0,  0,  0,  0,  0,  0]
        ],
        "mixin": false,
        "title": "2-7"
    },
    {
        "level": 13,
        "data": [
            [0,  0,  0,  0,  0,  0,  0,  0,  0,  0],
            [0,100,100,100,100,100,100,  0,  0,  0],
            [0,100, 52,  0,  0,  0,100,  0,  0,  0],
            [0,100,  0,  8,938,  0,100,  0,  0,  0],
            [0,100,  0,764, 51,100,100,  0,  0,  0],
            [0,100,  0,  0,  0,100,  0,  0,  0,  0],
            [0,100,100,100,100,100,  0,  0,  0,  0],
            [0,  0,  0,  0,  0,  0,  0,  0,  0,  0]
        ],
        "mixin": true,
        "title": "2-8"
    },
    {
        "level": 14,
        "data": [
            [0,  0,  0,  0,  0,  0,  0,  0,  0,  0],
            [0,  0,100,100,100,100,100,  0,  0,  0],
            [0,100,100,  0, 51, 64,100,  0,  0,  0],
            [0,100, 52,  8,  0, 38,100,  0,  0,  0],
            [0,100,  0,  9,  7,  0,100,  0,  0,  0],
            [0,100,  0,  0,  0,  0,100,  0,  0,  0],
            [0,100,100,100,100,100,100,  0,  0,  0],
            [0,  0,  0,  0,  0,  0,  0,  0,  0,  0]
        ],
        "mixin": false,
        "title": "2-9"
    },
    {
        "level": 15,
        "data": [
            [  0,   0,   0,  0,  0,  0,  0,   0,  0,  0],
            [  0,   0,   0,100,100,100,100, 100,  0,  0],
            [  0, 100, 100,100,  0,  0,  0, 100,  0,  0],
            [  0, 100,   0,  7, 64,  6, 51, 100,  0,  0],
            [  0, 100,   0,  9, 38,  8, 25, 100,  0,  0],
            [  0, 100,  52,  0,  0,  0,  0, 100,  0,  0],
            [  0, 100, 100,100,100,100,100, 100,  0,  0],
            [  0,   0,   0,  0,  0,  0,  0,   0,  0,  0]
        ],
        "mixin": false,
        "title": "2-10"
    },
    {
        "level": 16,
        "data": [
            [  0,  0,  0,  0,  0,  0,  0,  0,  0,  0],
            [100,100,100,100,100,100,100,100,  0,  0],
            [100, 52,  0,  7,  0,  0, 38,100,100,  0],
            [100,  0,  6,100,  8, 25,100, 51,100,  0],
            [100,  0,  0,  9,  0,  0, 64,  0,100,  0],
            [100,100,  0,  0,  0,  0,  0,  0,100,  0],
            [  0,100,100,100,100,100,100,100,100,  0],
            [  0,  0,  0,  0,  0,  0,  0,  0,  0,  0]
        ],
        "mixin": false,
        "title": "2-11"
    },
    {
        "level": 17,
        "data": [
            [  0,  0,  0,  0,  0,  0,  0,  0,  0,  0],
            [100,100,100,100,100,100,  0,  0,  0,  0],
            [100, 25, 51, 38,  0,100,100,100,  0,  0],
            [100,  0, 64,  0,  6,  0,  0,100,  0,  0],
            [100,  0,  0,  7,  8,  9,  0,100,  0,  0],
            [100,100,100,100,  0,  0, 52,100,  0,  0],
            [  0,  0,  0,100,100,100,100,100,  0,  0],
            [  0,  0,  0,  0,  0,  0,  0,  0,  0,  0]
        ],
        "mixin": false,
        "title": "2-12"
    },
    {
        "level": 18,
        "data": [
            [  0,  0,  0,  0,  0,  0,  0,  0,  0,  0],
            [  0,100,100,100,100,100,100,100,  0,  0],
            [100,100,  0,  0,  0,  0,  0,100,100,  0],
            [100,  0, 64,  9, 51,  6, 25,  0,100,  0],
            [100,  0,  7, 38,  8, 77, 10,  0,100,  0],
            [100, 52,  0,  0,  0,100,100,100,100,  0],
            [100,100,100,100,100,100,  0,  0,  0,  0],
            [  0,  0,  0,  0,  0,  0,  0,  0,  0,  0]
        ],
        "mixin": false,
        "title": "2-13"
    },
    {
        "level": 19,
        "data": [
            [0,  0,  0,100,100,100,100,100,  0,  0],
            [0,  0,  0,100,  0,  0,  0,100,  0,  0],
            [0,100,100,100,  6,  7,  0,100,100,  0],
            [0,100, 25, 51, 77, 64, 38,  0,100,  0],
            [0,100,100,100,  8,  9, 10,  0,100,  0],
            [0,  0,  0,100, 52,  0,  0,  0,100,  0],
            [0,  0,  0,100,100,100,100,100,100,  0],
            [0,  0,  0,  0,  0,  0,  0,  0,  0,  0]
        ],
        "mixin": false,
        "title": "2-14"
    },
    {
        "level": 20,
        "data": [
            [  0,  0,  0,  0,  0,  0,  0,100,100,100],
            [  0,  0,  0,  0,  0,  0,  0,100, 25,100],
            [  0,100,100,100,100,100,100,100, 38,100],
            [100,100, 52,  0,  0,  0,  0,100, 51,100],
            [100,  0,  6,  7,  8,  9, 10,  0, 64,100],
            [100,  0,  0,  0,  0,  0,  0,  0, 77,100],
            [100,100,100,100,100,100,  0,  0,100,100],
            [  0,  0,  0,  0,  0,100,100,100,100,  0]
        ],
        "mixin": false,
        "title": "2-15"
    }
]